444444444444444444444444444444
433333333333...E...33333333334
433333333333.......33333333334
433333333333.......33333333334
433333333333.......33333333334
433333333333.......33333333334
433333333333.......33333333334
433333333333.......33333333334
433333333333.......33333333334
433333333333.......33333333334
433333333333.......33333333334
433333333333.......33333333334
433333333333.......33333333334
433333333333.......33333333334
433333333333.......33333333334
433333333333.......33333333334
433333333333.......33333333334
433333333333.......33333333334
433333333333.......33333333334
433333333333.......33333333334
433333333333.......33333333334
433333333333.......33333333334
433333333333.......33333333334
433333333333...D...33333333334
444444444444444444444444444444
